4 4 4 4 4 4 4 4 4 6 6 6 6 6 6 6 6 6 6 6 6 6 6 6 6 6 6 6 6 6 6 6 6 6 6 6 6 6 6 6 6 6 6 4 4 4 4 4 4 4
4 6 6 6 6 6 6 0 4 6 8 8 7 8 8 7 8 8 7 7 7 7 7 7 7 7 7 7 7 7 7 7 7 7 7 7 7 8 8 7 8 8 6 0 0 0 0 0 0 4
4 6 2 2 2 2 6 0 4 6 7 7 7 7 7 7 7 7 7 7 7 7 7 7 7 7 7 7 7 7 7 7 7 7 7 7 7 7 7 7 7 7 6 0 0 0 0 0 0 4
4 6 2 2 2 2 6 0 4 6 6 6 6 6 6 6 6 6 6 6 6 6 6 6 6 6 6 6 6 6 6 6 7 7 6 6 6 6 6 6 6 6 6 0 0 0 0 0 0 4
4 6 6 6 6 6 6 0 4 4 4 4 4 4 4 4 4 4 4 4 2 2 2 2 2 2 2 4 4 4 4 4 1 1 4 4 4 4 4 4 4 4 4 4 4 4 4 4 4 4
4 0 0 3 0 0 0 0 4 4 4 4 4 4 4 4 4 4 4 4 2 2 2 2 2 2 2 4 4 4 4 4 1 1 4 4 4 4 4 4 4 4 4 4 4 4 4 4 4 4
4 0 0 3 0 0 0 0 0 0 0 0 0 4 4 4 4 4 4 4 4 2 2 2 2 2 4 4 4 4 4 4 1 1 4 4 4 4 4 4 4 4 4 4 4 4 4 4 4 4
4 0 0 3 3 3 3 3 3 3 3 3 3 3 3 3 3 3 3 0 0 0 0 0 0 0 0 4 4 4 4 4 1 1 5 5 5 5 5 5 5 4 4 4 4 4 4 4 4 4
6 6 6 6 6 6 6 6 6 6 6 6 6 6 6 0 0 0 3 0 0 0 0 0 0 0 4 4 4 4 4 4 1 1 5 5 5 5 5 5 5 5 4 4 4 4 4 4 4 4
6 7 7 7 7 7 7 7 7 7 7 7 7 7 6 0 0 0 3 0 0 0 0 0 0 4 4 4 4 4 4 4 1 1 5 5 5 5 5 5 5 5 4 4 4 4 4 4 4 4
6 7 7 7 7 7 7 7 7 7 7 7 7 7 6 0 0 0 3 0 0 0 0 5 4 4 4 4 4 4 4 4 1 1 5 5 5 5 5 5 5 5 4 4 4 4 4 4 4 4
6 7 7 7 7 7 7 7 7 7 7 7 7 7 6 0 0 0 3 0 0 0 0 5 4 4 4 4 4 4 4 4 1 1 5 5 5 5 5 5 5 5 4 4 4 4 4 4 4 4
6 7 7 7 7 7 7 7 7 7 7 7 7 7 6 0 0 0 3 0 0 0 0 5 4 4 4 4 4 4 4 4 1 1 4 5 5 5 5 5 5 4 4 4 4 4 4 4 4 4
6 7 7 7 7 7 7 7 7 7 7 7 7 7 7 1 1 1 1 1 1 1 1 1 1 1 1 1 1 1 1 1 1 1 4 4 4 4 5 4 4 4 4 4 4 4 4 4 4 4
6 7 7 7 7 7 7 7 7 7 7 7 7 7 7 1 1 1 1 1 1 1 1 1 1 1 1 1 1 1 1 1 1 1 4 4 4 4 5 4 4 4 4 4 4 4 4 4 4 4
6 6 7 7 6 6 6 6 6 6 6 6 6 6 6 4 4 4 4 4 4 4 4 1 4 4 4 4 4 4 4 4 4 4 4 4 4 4 5 4 6 6 6 6 6 6 6 6 4 4
6 7 7 7 7 7 7 7 7 7 7 7 7 7 6 4 4 4 4 4 4 4 4 1 4 4 4 4 4 4 4 4 4 4 4 4 4 4 5 4 6 8 8 7 7 8 8 6 4 4
6 7 7 7 7 7 7 7 7 7 7 7 7 7 6 4 4 4 4 4 4 4 4 1 4 4 4 4 4 4 4 4 4 4 4 4 4 4 5 4 6 7 7 7 7 7 7 6 4 4
6 8 8 8 8 7 7 7 7 7 8 8 8 8 6 4 4 4 4 4 4 4 0 1 0 4 4 4 4 4 4 4 4 4 4 4 5 5 5 4 6 7 7 7 7 7 7 6 4 4
6 7 7 7 7 7 7 7 7 7 7 7 7 7 6 4 4 4 4 4 4 0 0 1 0 0 4 4 4 4 4 4 4 4 4 4 5 4 4 4 6 7 8 7 7 8 7 6 4 4
6 8 8 8 7 8 8 8 8 7 8 8 8 8 6 4 4 4 4 4 0 0 0 1 0 0 0 4 4 4 4 4 4 4 4 5 5 4 4 4 6 7 7 7 7 7 7 6 4 4
6 7 7 7 7 7 7 7 7 7 7 7 7 7 6 0 0 1 1 1 1 1 1 1 1 1 1 1 1 1 1 1 1 1 1 1 1 1 1 1 7 7 7 7 7 7 7 6 4 4
6 6 6 6 6 6 6 6 6 6 6 6 6 6 6 4 4 3 4 4 0 0 0 1 0 0 0 4 4 4 4 4 4 4 4 4 5 4 4 4 6 7 7 7 7 7 7 6 4 4
4 4 4 4 4 4 4 4 0 4 4 4 0 4 4 4 4 3 4 4 4 0 0 1 0 0 4 4 4 4 4 4 4 4 4 4 5 4 4 4 6 8 8 7 7 8 8 6 4 4
4 3 3 3 3 3 3 3 3 3 3 3 3 4 4 4 4 3 4 4 4 4 0 1 0 4 4 4 4 4 4 4 4 4 4 4 5 4 4 4 6 7 7 7 7 7 7 6 4 4
2 2 2 2 2 2 2 3 3 3 3 3 3 3 3 3 3 3 4 4 4 4 4 1 4 4 4 4 4 4 4 4 4 4 4 4 5 4 4 4 6 6 6 6 6 6 6 6 4 4
2 2 2 2 2 2 2 3 0 4 4 4 4 4 0 4 4 4 4 4 4 4 4 1 4 4 4 4 4 4 4 4 4 4 4 4 5 4 4 4 4 4 4 4 4 4 4 4 4 4
2 2 2 2 2 2 2 3 0 4 4 4 4 4 0 4 4 4 4 4 4 4 4 1 4 4 4 0 4 4 4 4 4 4 4 0 5 4 4 4 4 4 4 4 4 4 4 4 4 4
2 2 2 2 2 2 2 3 0 4 4 4 4 4 0 4 4 4 4 4 4 4 4 1 4 4 4 4 4 4 0 4 4 4 4 4 5 4 4 4 4 4 4 4 4 4 4 4 4 4
2 2 2 2 2 2 2 3 0 0 0 0 0 0 0 4 4 4 4 4 4 4 4 1 4 4 4 4 4 4 0 4 4 4 4 4 5 4 4 4 4 4 4 4 4 4 4 4 4 4
2 2 2 2 2 2 2 3 0 0 0 0 0 0 0 4 4 4 4 4 4 4 4 1 4 4 4 4 4 4 4 4 4 4 4 4 0 4 4 4 4 4 4 4 4 4 4 4 4 4
2 2 2 2 2 2 2 3 0 0 0 0 0 0 0 4 4 4 4 4 4 4 4 1 4 4 4 4 4 4 4 4 4 4 4 0 0 0 4 4 4 4 4 4 4 4 4 4 4 4
4 3 3 3 3 3 3 3 0 0 0 0 0 0 0 4 4 4 4 4 4 4 4 1 4 4 4 4 4 4 4 4 4 4 4 0 0 0 4 4 4 4 4 4 4 4 4 4 4 4
4 4 4 4 4 4 4 4 0 0 0 0 0 0 0 4 4 4 4 4 4 4 4 1 4 4 4 4 4 4 4 4 4 4 4 0 0 0 4 4 4 4 4 4 4 4 4 4 4 4
4 4 4 4 4 4 4 4 0 0 0 0 0 0 0 4 4 4 4 4 4 4 4 1 4 4 4 4 4 4 4 4 4 4 4 0 0 0 4 4 4 4 4 4 4 4 4 4 4 4
4 4 4 4 4 4 4 4 1 1 1 1 1 1 1 1 1 1 1 1 1 1 1 1 4 4 4 4 4 4 4 4 4 4 4 0 0 0 4 4 4 4 4 4 4 4 4 4 4 4
4 4 4 4 4 4 4 4 1 0 0 4 0 0 4 0 0 0 4 0 0 0 0 0 0 0 0 4 4 4 4 4 4 4 0 0 0 0 0 4 4 4 4 4 4 4 4 4 4 4
4 4 4 4 4 4 4 4 1 0 0 0 0 0 0 0 0 0 0 0 0 0 0 0 0 0 0 0 4 4 0 4 4 0 0 0 0 0 0 4 4 4 4 4 4 4 4 4 4 4
4 4 4 4 4 4 4 4 1 0 0 0 0 0 0 0 0 0 0 0 0 0 0 0 0 0 0 0 4 4 4 4 0 0 0 0 0 0 0 4 4 4 4 4 4 4 4 4 4 4
4 4 4 4 4 4 4 4 1 4 4 4 4 0 4 4 4 4 0 0 0 0 0 0 0 0 0 0 0 4 4 4 0 0 0 0 0 4 0 4 4 4 4 4 4 4 4 4 4 4
4 4 4 4 4 4 4 4 1 4 4 4 4 4 4 4 4 4 0 0 0 0 0 0 0 0 0 0 0 0 0 0 0 0 4 0 0 0 0 4 4 4 4 4 4 4 4 4 4 4
4 4 4 4 4 4 4 4 1 4 4 4 4 0 4 4 4 4 4 0 0 0 0 0 0 0 0 4 4 4 4 0 0 0 0 0 0 0 0 4 4 4 4 4 4 4 4 4 4 4
4 4 4 4 4 4 4 4 1 4 4 4 4 4 4 4 4 4 4 4 0 0 0 0 0 0 4 4 4 4 4 0 0 4 0 0 4 0 0 4 4 4 4 4 4 4 4 4 4 4
4 4 4 4 1 1 1 1 1 4 4 4 4 4 4 4 4 4 4 4 4 4 4 4 4 4 4 4 4 4 4 4 0 0 0 0 0 0 4 4 4 4 4 4 4 4 4 4 4 4
6 6 6 6 7 7 6 6 6 4 4 4 4 4 4 4 4 4 4 4 4 4 4 4 4 4 4 4 4 4 4 4 4 4 4 4 4 4 4 4 4 4 4 4 4 4 4 4 4 4
6 7 7 7 7 7 7 7 6 4 4 4 4 4 4 4 4 4 4 4 4 4 4 4 4 4 4 4 4 4 4 4 4 4 4 4 4 4 4 4 4 4 4 4 4 4 4 4 4 4
6 7 7 7 7 7 7 7 6 4 4 4 4 4 4 4 4 4 4 4 4 4 4 4 4 4 4 4 4 4 4 4 4 4 4 4 4 4 4 4 4 4 4 4 4 4 4 4 4 4
6 6 6 6 6 6 6 6 6 4 4 4 4 4 4 4 4 4 4 4 4 4 4 4 4 4 4 4 4 4 4 4 4 4 4 4 4 4 4 4 4 4 4 4 4 4 4 4 4 4
2 2 2 2 2 2 2 2 2 4 4 4 4 4 4 4 4 4 4 4 4 4 4 4 4 4 4 4 4 4 4 4 4 4 4 4 4 4 4 4 4 4 4 4 4 4 4 4 4 4
2 2 2 2 2 2 2 2 2 4 4 4 4 4 4 4 4 4 4 4 4 4 4 4 4 4 4 4 4 4 4 4 4 4 4 4 4 4 4 4 4 4 4 4 4 4 4 4 4 4